************************************************************************1
*       *****       *****                                   *************
S       *****   *********   *********           *****       *************
*           *   *********           *               *       *************
******      *   *****   *********   *****************   *****************
*****           *                   *****************   *****************
*********   *********   *   *************************   *****************
*           *       *   *   *********   *   *****   *   *****   *****   *
*****   *       *       *   *********   *   *****   *   *****   *****   *
*       *       *       *               *               *****           *
*   *****   *   *   *****   *****   *   *****   *****   *************   *
*   *   *   *   *   *       *****   *   *       *   *   *********   *   *
*   *   *********   *   *****************   *   *   *************   *   *
*   *           *   *   *   *****           *                           *
*   *********   *   *   *   *****   *********   *********   *   *********
*           *   *   *       *****   *********   *********   *   *********
*************   *****************************************   *************
*********           ****                                            *****
******      *************   *********************   *********       *****
*               *****       *********           *   *               *****
*********************       *********      Ing  *************************
*****                                           *************************
*************************************************************************
