************************************************************************3
S               *                                   *                   *
*************   ****   **********   *********   *****************   *****
*       *                   *       *****   *   *   *****           *   *
*   *   *********   *   *****   *********   *   *   *******   ***   *   *
*   *           *   *   *       *                               *       *
*   *********   *   *   *   *****   *********   *********   *   *********
*   *****   *       *   *   *   *           *               *   *********
*   *****   *****   *   *****   *   *********   *   *   *   *************
*       *       *   *   *       *       *       *   *   *       *       *
*****   *****   *   *   *   *********   *   *****   *   *   *   *****   *
*       *       *   *   *               *       *   *   *   *           *
*   *****   *   *********   *****   *   *****   *****   *************   *
*           *                       *       *   *                   *   *
*   *   *********   *   *****   *********   *       *************   *   *
*   *       *   *       *   *   *****   *   *   *       *   *****   *   *
*********   *   *********   *********   *****   *   *   *   *********   *
*       *   *               *           *   *       *   *           *   *
*   *   *************   *   *   *********   *****   *   *********   *   *
*   *                   *   *           *       *   *   *   *           *
*****   *********************************   *********   *****     Ing   *
*               *****************               *****   *               *
*************************************************************************
